111111111111111111111111
100000410000500000010001
101111111111111011111101
101000100000001010000001
100010001111101010111111
111110100000111010000001
100000111110010010111101
101110100011010110000101
100000001000010111111101
101011011111110100000001
161001000100100101111101
101100010001110000000101
101111111111311111110101
101100000000500000000101
101001111111011111110101
100011000000050000000001
101001110101110101111111
101100000100010101000101
100111110001010101010101
110000010111110101010161
100111110000000100010001
161100000101111111111101
101001111100050000000001
111111111111111111111111