111111111111111111111111
100000010000001000010001
101011010111111011110111
101010010000000010000101
101011411110111016111101
111011111110101010010101
105000000010100010110101
111111111010111010010101
160010001010101010110101
101000101010100000000101
101111101000101111010101
101000001111100001010101
101111101000111111010101
101000101010000000000101
101010111111111111110101
101010100050000100010101
101010111111110101010101
101010010001000101010101
101011010100010001000101
101111011111111111110101
160000000000100000000001
101111011111101111111111
100000000005000000000031
111111111111111111111111